####      #####
#  ########   #
#         ... #
#  ####### #$##
## #     # # #
 # # *** # # #
 # # * * # # #
 # # * . # # #
 # # * $ # # #
 # # *#### # #
 #**       # ##
## ##$######  #
#    $ @      #
#   ########  #
#####      ####
