##### #########
#   ###   #   #
# *     $  .# #
## ## #####$$ #
 # #  #   # ###
 # #      # ##
 # #####..#  #
 # #   #..   #
 # # # $..####
## # $ #..  #
#  # #### #$##
# $$   @   $ #
#  #######   #
####     #####
