       ####  #####
  ######  ####   #
 ##              ##
 # $#$ $  ## ###  #
 #.    ##### .... #
##.##### @ # .... #
#      #$ $####.###
#   #  $ $ $ $  #
####### $ $ $ #.#
      #         #
      ###########
