#########
#       #
# # *** #
#    * ##
## # * ##
## # *  #
# *  *# #
# #.* $@#
#    ####
######
