   ####
####  #
#  $  ##
# #$#  #
#. $   #
#.###  #
#. @  ##
#######
