 ############
 #          #
## ######## #
#         # #
# *###### # #
# . #   # # #
# *$# $   # #
# * ## ## # #
# *     # # #
# * #   # # #
# * ##### # #
#.*       # #
# ######### #
#     @     #
#############
