####
#  ########
#        .#####
#  ###### #   #
##$##  #..  . #
# $    #.. # ##
#   #  ##### #
##### ##  ## #
   # $    ## #
   #   #  ## ##
   ##### ###  #
      # $  $$ #
      # @ ##  #
      #########
