########
#. #   #
#  $   #
# * # ##
## # $.#
#   $  #
#  .# @#
########
