 ##########
 #        #
 # # # ## #
 # * * *  #
## * * * ##
#. *#* $ #
#    * @##
#########
