##############
#            ##
# **********. #
# *  @      * #
# * ####### * #
# * #     # * #
# * ##### # * #
# **    # # * #
#  $*** # #$. #
#     * ### * #
#######       #
      #########
