    #######
   ##  #  #
  ##  * $ #
 ##  * #  #
 #  *  # ##
 # * ### #
 #. ##   #
### #  ###
#     ##
# @ ###
#####
