###############
#@            #
# *** *** *** #
# * * * * * * #
# . * * * * $ #
### *** ***   #
  #    #     ##
  ############
