########
#      #####
#  $ $ #   #
# $ $  $$# #
###### #   #
 #   # #..##
 # $    ..#
 ##$##### ##
 #  #..    #
 # @ ..#   #
 ###########
