#####
#   #####
# # # @ #
# $$$$# #
# $ # * #
# # . $##
# .# #. #
#   .#  #
##.#    #
 #.   ###
 #  ###
 ####
