#####     ####
#   #######  #
# $        $ #
## ########  #
 # #   #  # ##
 # # $  ..#  #
 # ##$##..   #
 # #   $..####
## # $ #..  #
#  # #### # #
# $$   @    #
#  ##########
####
