#########
#   ##  #
#       #
###.... #
# $$$ $ #
# @ #####
#####
