##########
#  . . . #
#  $ $ $ #
##.#######
#     $  #
#@ $     #
#######.##
# $ $ $  #
# . . .  #
##########
