    ####
#####  ###
#   #   @###
# #    #$  #
#   ##$ $  #
#  ... #   #
#   ########
#####
