       ############
       #          #
       # ######## #
    #### #   #  # #
    #    #   $$ # #
    # #####$##  # #
 #### #   #  #.## #
 #    #   $  #.#  #
 # #####$##  #.# ##
## #   #  ####.# #
#  #   $  #  #.# #
# ###$##  #  #.# #
#   #  #######.# #
# @ $  #      .# #
##*##  # #     # #
 #  ####       * #
 #             ###
 ###############
