##########
#    #   #
#   .....#
#   ### ###
#    #    #
#### #$$$ #
  #   $@$ #
  #   #  ##
  ########
