############
#          #
#  *###### #
## *     * #
#  * *** # #
# ## # * # #
#  # # . # #
## # * $ # #
 # # ##### ##
 # # @    * #
 #   ####   #
 #####  #####
