    ########
    #   #  #
    # $    #
###### ### #
#        # ##
#.*******#  #
#   @       #
#######  ####
      ####
