 ####
 #  ############
 # * * *       ##
## # +...#*# $  #
#  ##*####  #   #
#      $ $$ #####
#  # *      #
#############
