 ########
 #      #
##$#### #
# $     #
# #  ## #
#  .*.# ##
###*@*   #
 # .*.#  #
 # #  # ##
 # $$## #
 ###    #
   ######
