#########
#       #
#   #   #
# **.** #
##   $ ##
# ***** #
#   @   #
#########
