 #########
 #   #   #
 # $     #
 ##$#### #
  #..  # #
  #..# # #
  #  $ # #
####$### ##
#  $ #... #
#    @.*. #
## ########
#  $     #
# $ $$   #
#    #####
######
