    ####
#####  #
#   #  #
# ...  #
##.## ###
 #  $$$ #
 #### $ #
    # @ #
    #####
