#############
#  *  .  .  #
#     $     #
## ####### ##
#....#     #
#..#.#$$$$ #
#..$.#   $ #
#....#   $ #
###$## $ $ #
 #  #@$$$$ #
 #  $     ##
 #  #######
 ####
