    #######
#####.    #
#    $ $  #
#@  #. ####
########
