   #####   ####
   #   #####  #
   # $        #
#####$######  #
# ..#  #   # ##
# .. ..#   # #
## ######### #
#  # $ $ $ $ #
#       @    #
##  ##########
 ####
