    #####
    #   #
    #.  #
  ###  .##
  #  . . #  #####
### # #  #  #   ####
#   # ## ####$$    #
# .  .        $$$$ #
#####.###$#@#      #
    #     ##########
    #######
