    #####
    #   #
##### # #
#   # $ #
# $$...####
#   *@*   #
####...$$ #
  # $ #   #
  # # #####
  #   #
  #####
