  ######
###    #
#  $$$ #
# ## # #
#  ... #
### @ ##
  #####
