    ########
    #   #  #
    # $    #
###### ### #
#   #    # #
#.*******# #
#     #    #
##### # @# ##
   ## ####  #
   #        #
   #   ###  #
   ##### ####
