      ########
 ######.  #  #
 # ...  # $$ #
 # # ...  #  #
##$###$#### ##
#   #        #
# $   $$#    #
####### @ ####
      #####
