  ####
  #  ####
  #     #
### ##  #
#..  # ##
#..  # #
# #### ##
# # $   #
# # $$$ #
# @  #  #
#########
