 #######
 #  #  ##
##..    #
# ..#   #
# ### ###
#   $$$ #
##### $ #
    # @ #
    #####
