#######
#     #
# ### ###
# # $   #
# #     #
# $$ #$##
# $  # ##
## ###. #
 # .+.. #
 ########
